...B...B
...B...B
...B...B
.B...B..
.B...B..
.B...B..
TB...B..
.B..PBG.